
NO ./includes/texture/me.png
SO ./includes/texture/chat_sud.png
WE ./includes/texture/chat_ouest.png
EA ./includes/texture/chat_est.png

F 255,200,200
C 0,255,0
	1111111111111111111111111
	10000000001100000000000011
	1011000001110000a00W0000101
	100100000000000000000000S101
	111111111011000001110000111
100000000011000001110111111111111
11110111111111011100000010001
11110111111111011101010010001
11000000110101000000000000001
10000000000000001100000010001
10000000000000001101010010001
1100000111010101111101111000111
11110111 1110101 101111010001
11111111 1111111 111111111111
