
NO ./includes/texture/me.png
SO ./includes/texture/chat_sud.png
WE ./includes/texture/chat_ouest.png
EA ./includes/texture/chat_est.png

FC 220,100,0
C 0,0,2
111111111
11110000011111
11111111N11   
111  1111111