NO ./includes/pictures/chat_est.png
SO ./includes/pictures/me.png
WE ./includes/pictures/chat_est.png
EA ./includes/pictures/chat_est.png

F 255,100,0
C 255,100,12



11111111111
10000000001
10000000001
11101110111 1
10101010001 1 1
1000000N001 1 1 1
11111111111 1 1 1 1

1111

111

11

1