NO ./includes/pictures/chat_est.png
SO ./includes/pictures/me.png
WE ./includes/pictures/chat_est.png
EA ./includes/pictures/chat_est.png
F 0,255,255
C 0,0,255
11110
1 N10
1 010
11110	1
000000
1
