NO ./includes/texture/me.png
SO ./includes/texture/chat_sud.png
WE ./includes/texture/chat_ouest.png
EA ./includes/texture/chat_est.png
F 0,255,255
C 0,0,255
111111111111111
100000000000001
100000000000001
100000000N00000
100000000000001
100000000000001
100000000000001
100000000000001
100000000000001
111111111111111
