NO ./includes/texture/me.png
SO ./includes/texture/chat_sud.png
WE ./includes/texture/chat_ouest.png
EA ./includes/texture/chat_est.png
F 0,255,255
C 0,0,255
1111
1 N1
1 01
1111	1
0
1