NO ./includes/pictures/chat_est.png
SO ./includes/pictures/me.png
WE ./includes/pictures/chat_est.png
EA ./includes/pictures/chat_est.png
F 0,255,255
111111111111111
100000000000001
100000000000001
10000N000000001
100000000000001
100000000000001
100000000000001
100000000000001
100000000000001
111111111111111
C 0,0,255
